##### Dexter Industries dIMU #####

DIMU_driver	KEYWORD1

AXIS_X	LITERAL1
AXIS_Y	LITERAL1
AXIS_Z	LITERAL1


ClassDIMUGyro	KEYWORD1

Config	KEYWORD2
ReadAxis	KEYWORD2
ReadAxes	KEYWORD2

DIMU_GYRO_I2C_ADDR	LITERAL1

DIMU_GYRO_RANGE_250	LITERAL1
DIMU_GYRO_RANGE_500	LITERAL1
DIMU_GYRO_RANGE_2000	LITERAL1


ClassDIMUAccel	KEYWORD1


Config	KEYWORD2
ReadAxis8Bit	KEYWORD2
ReadAxes8Bit	KEYWORD2
ReadAxis10Bit	KEYWORD2
ReadAxes10Bit	KEYWORD2
Calibrate	KEYWORD2

DIMU_ACCEL_I2C_ADDR	LITERAL1

DIMU_ACCEL_RANGE_2G	LITERAL1
DIMU_ACCEL_RANGE_4G	LITERAL1
DIMU_ACCEL_RANGE_8G	LITERAL1



##### HiTechnic Accelerometer #####

HTAC_driver	KEYWORD1
ClassHTAC	KEYWORD1

ReadAxis	KEYWORD2
ReadAxes	KEYWORD2

AXIS_X	LITERAL1
AXIS_Y	LITERAL1
AXIS_Z	LITERAL1



##### HiTechnic Color Sensor #####

HTCS_driver	KEYWORD1
ClassHTCS	KEYWORD1

ReadColor	KEYWORD2
ReadRGB	KEYWORD2



##### HiTechnic Gyro #####

HTGYRO_driver	KEYWORD1
ClassHTGYRO	KEYWORD1

ReadRotation	KEYWORD2
Calibrate	KEYWORD2



##### HiTechnic IR Receiver #####

HTIRR_driver	KEYWORD1
ClassHTIRR	KEYWORD1

ReadValue	KEYWORD2
ReadChannel	KEYWORD2
ReadAllChannels	KEYWORD2

HTIRR_CHANNEL_1	LITERAL1
HTIRR_CHANNEL_2	LITERAL1
HTIRR_CHANNEL_3	LITERAL1
HTIRR_CHANNEL_4	LITERAL1
HTIRR_MOTOR_1A	LITERAL1
HTIRR_MOTOR_1B	LITERAL1
HTIRR_MOTOR_2A	LITERAL1
HTIRR_MOTOR_2B	LITERAL1
HTIRR_MOTOR_3A	LITERAL1
HTIRR_MOTOR_3B	LITERAL1
HTIRR_MOTOR_4A	LITERAL1
HTIRR_MOTOR_4B	LITERAL1



##### HiTechnic IR Seeker #####


HTIRS_driver	KEYWORD1
ClassHTIRS	KEYWORD1

ReadDirection	KEYWORD2
ReadStrength	KEYWORD2



##### HiTechnic Compass #####

HTMC_driver	KEYWORD1
ClassHTMC	KEYWORD1

ReadHeading	KEYWORD2
StartCal	KEYWORD2
StopCal	KEYWORD2



##### Lego Sound Sensor #####

NXTSound_driver	KEYWORD1
ClassNXTSound	KEYWORD1

SoundLevel	KEYWORD2
SetDB	KEYWORD2
SetDBA	KEYWORD2